1111111111111111
1P000000C0000001
1011111111101001
1C00100000010001
1101110000101111
10000C1000100E01
1001110001000001
1010001011000011
1000000010000001
1101110001100101
1C0000C000010001
1000001000011001
1111111111111111
