1111111111111111111
1P000000000C0000001
1011111110001110001
1100C00010000011001
1C00100010000010011
1000111100111100011
110000C001000001111
1011101011001100001
1C00110000000000101
1E001001111100000C1
10001100000C0000111
1111111111111111111
