11111111111111111111111
10C00000000000000000001
10000000001001111010001
10110C00011000001001101
10C110001010000C1001C01
10010001001001111001001
10C10011111101000001001
10110000001001C00001101
100000P000100111101C001
100001000000C0E000000C1
11111111111111111111111
