11111111111111111111111
10C00X0000000000X000001
100000000010011110X0001
10110C00011000001001101
10C1X0001010000C1001C01
10010001001001111001001
10C10011111101000001001
10110000001001C00001101
100000P00010011110XC001
10000X000000C0E000000C1
11111111111111111111111
