1111111
1E0C1C1
10P0101
1111111
