11111111111111111111111111111111111111111111111111111111111111111111
1EP000000000000C00000C0000000000000010010100100000101001000000010101
10100101001000001010010000000101000010010100100000101001000000010101
10100100101010100010010000000101000101001001010101000100100000001011
100000000C00C0000000000000000000C000000000C00C0000000000C000000000C1
1010010010101010001001000000010100000000000C00C0000000000000000000C1
100000000C00C0000000000000000000C0000000000C00C0000000000000000000C1
1010010100100000101001000000010100000000000C00C0000000000000000000C1
1010010010101010001001000000010100000000000C00C0000000000000000000C1
100000000C00C0000000000000000000C0000000000C00C0000000000000000000C1
101001001010101000100100000001010CC00000000C00C0000000000000000000C1
100000000C00C0000000000000000000C1C00000000C00C0000000000000000000C1
11111111111111111111111111111111111111111111111111111111111111111111
