1111111111111111111111111111111111
1EP000000000000C00000C000000000001
1000000000000000000000000000000001
1000000000000000000000000000000001
100000000C00C0000000000000000000C1
1000C00000CC000000C0000C0000000C01
100000000C00C0000000000000000000C1
1000000000000000000000000000000001
1000000000000000000000000000000001
100000000C00C0CCCCCCCCCCCCCCCCC0C1
1000000000000000000000000000000001
100000000C00C0CCCCCCCCCCCCCCCCC0C1
1111111111111111111111111111111111
