1111111111111
1C010000000P1
100000E000001
1000000000001
1111111111111
