1111111111111
1C010000000P1
1000011111001
100011E000001
1111111111111
