1111111111111
1111111111111
1111111111111
1111111111111
1111111111111
1111111100111
1111111111111
1111111111111
1111111111111
1111111111111
1P00000ECCC01
1111111111111
