1111111111111111111111111111111111
1E0000000000000C00000C00000000C001
10100101001000001010010000CC010101
1010010010101010001001000000010101
1P0000000C00C00000C00000CC000000C1
1111111111111111111111111111111111
