111111
1E0001
1C0C11
111C01
11CP11
111111
