11111111111111111111111111111
1P00C001000C0000C001000CC0C01
10110101011100101C10101011101
1010010100010C1010010100010C1
1000C0011101001000C0011101001
1110110000C1101110110000C1101
1C0001011000001C0001011000001
11110100001110111101000011101
100C011101100C100C011101100C1
10100000000011101000000000011
101C11101110C0111111111111C01
10000000000C001E00CCC0CC0C001
11111111111111111111111111111
