1111111111111
1000000000001
1P00C001000C1
1000000000001
1111111111111





