11111111
10001111
1P0E00C1
11111111
10000001
11111111
