1111111111
1000E0P001
1111000001
1111011011
1C00000001
1000000001
1111000001
1111011011
1C00000001
1111000001
1111011011
1C00000001
1111000001
1111011011
1C00000001
1111000001
1111011011
1C00000001
1111000001
1111011011
1C00000001
1111000001
1111011011
1C00000001
1111000001
1111011011
1C00000001
1111000001
1111011011
1C00000001
1111000001
1111011011
1C00000001
1111000001
1111011011
1C00000001
1111000001
1111011011
1C00000001
1111000001
1111011011
1C00000001
1111111111
