1111111111111111111111111111111111111111111111111111111111111111111111111111111111111111111111111111111111111111111111111111111111111111111111111111111111111111111111111111111111111111
110000E0000000C0001111111000000000000C0001111111000000000000C0001111111000000000000C0001111111000000000000C0001111111000000000000C0001111111000000000000C0001111111000000000000C00011111
11000000P0000000000000000000000000000000000000000000000000000000000000000000000000000000000000000000000000000000000000000000000000000000000000000000000000000000000000000000000000000001
1100000011111111001111111000000111111110011111110000001111111100111111100000011111111001111111000000111111110011111110000001111111100111111100000011111111001111111000000111111110011111
1111011111111100011111111110111111111000111111111101111111110001111111111011111111100011111111110111111111000111111111101111111110001111111111011111111100011111111110111111111000111111
1111011111111101111001111110111111111011110011111101111111110111100111111011111111101111001111110111111111011110011111101111111110111100111111011111111101111001111110111111111011110011
1111000000000001111000111110000000000011110001111100000000000111100011111000000000001111000111110000000000011110001111100000000000111100011111000000000001111000111110000000000011110001
1111111111111111111111111111111111111111111111111111111111111111111111111111111111111111111111111111111111111111111111111111111111111111111111111111111111111111111111111111111111111111
